##########
#  S     #
# ### ## #
# #    # #
# #  # # #
# ## #####
# #      #
# # #  # #
##### ####
#   #  # #
# #   ##E#
##########